#BLUE COUNTRY
5 5 362 392 412 451 475
5 12 475 492 503 511 539 534 562 583 602 610 625 635 
5 4 635 640 647 666
5 7 362 363 378 393 413 447 489
5 6 489 452 423 420 391 344
5 7 489 516 557 565 588 605 625
5 7 489 466 452 423 420 391 344
5 8 363 364 334 340 335 323 327 344
5 6 362 326 318 280 253 222
5 8 362 339 308 306 272 245 217 223
5 8 223 204 184 164 144 132 119 106 
5 6 106 92 79 72 77 62 
5 5 223 241 257 289 323
5 10 222 180 181 165 151 139 129 121 114 106
5 5 223 218 205 187 191 
5 8 253 284 321 353 390 422 427 475
5 3 475 482 522
5 3 222 185 167
5 3 539 561 580
5 5 191 209 243 274 312
5 10 423 453 484 524 535 568 581 597 615 635
5 2 640 645
5 2 139 137
5 3 119 115 110
5 3 484 478 468
5 2 62 59
5 2 272 231
5 2 185 163
5 2 482 499
5 2 191 214
5 2 468 496 
5 2 489 481 
#BLU Connect 
5 3 666 667 678 
5 2 667 671
5 3 344 379 401 
5 2 344 356
5 3 344 312 285
5 2 62 81
#RED COUNTRY
5 8 384 403 436 439 470 493 527 526
5 7 526 546 572 595 616 621 636
5 7 636 649 661 665 676 680 673
5 6 384 408 417 454 488 510
5 10 384 370 388 365 346 350 387 383 382 381
5 5 384 351 303 279 268
5 7 384 351 337 316 294 287 244
5 8 244 210 188 170 154 130 120 111
5 4 111 99 87 78
5 7 244 278 277 310 322 357 381
5 7 526 518 491 479 441 430 381
5 8 268 301 304 352 400 418 450 488
5 9 510 536 554 578 592 585 603 613 616
5 9 268 252 220 211 192 171 157 160 154 
5 4 479 525 531 549
5 2 636 638 
5 2 536 552
5 2 470 506
5 2 268 240
5 2 252 201
5 2 531 520 
5 2 621 620
#RED Connect
5 2 381 375
5 3 78 74 86 
5 2 74 60
5 4 310 290 258 266
5 3 381 359 330 
5 3 381 411 446
5 2 673 662
5 2 673 681
5 2 60 52 
5 2 99 95
#BLU-RED Connect
5 4 681 687 686 678
5 4 662 659 658 671
5 4 446 476 485 468
5 4 375 405 410 401 
5 4 330 336 345 356
5 4 266 292 299 285
5 4 86 82 83 81 
5 4 60 55 53 59